###########################################
#.....#...#.........###..####.........##..#
#.....#...##....##........########.......##
###.#####.####............#####.........###
#....##.............#.....#...............#
#....######...............#....####.......#
#............#####........####....#########
###..#..........####......#.......#......##
####..#######........###...###....#.....###
####....############...##.........#.....###
#........#.......###....####......#.....###
#........#...#####......#...#..####.....###
#.....#..#.............##...............###
###.###....#########....####.....#####..###
#.....#........#....................##....#
#....##........####.....########..###.....#
###............#.............####.....###.#
#......###.....#.....########.....#...#...#
#....#####.#####...#.........####...###...#
#.........#...............................#
#......###.....############..###.#####....#
#..#######................#........##.....#
#...............###############.....#.....#
############..###########.########.###.####
#.........#..................##...........#
#......###.....############..###.#####....#
#..#######................#.......######..#
#...............###############...........#
###########################################
