#############################################
#......#......#.............###...###.......#
#.....#...##....##........#######..##.......#
###.#####.####............#####....######..##
#....######...............#....###..........#
#............#####........####.......########
###..#..........####......#.......#..##.....#
####..#######........###...###....#..##....##
####....############...##.........#..##....##
#........#.......###....####......#..##.....#
#........#...#####......#...#..####..#####..#
#.....#..#.............##...................#
###.###....#########....####.....#####.....##
#.....#........#....................#####...#
#....##........####.....########..###.......#
###............#.............####........####
#......###.....#.....########.........#....##
#....#####.#####...#.........####...###....##
#......###.....############..###.#####.....##
#..#######................#........##......##
############..###########.########.###....###
#............................##.............#
#......###.....############..###.#####.....##
#..#######................#.......###########
#############################################
